
Laila	Bakken	
Stig	Bjørnsen	stig120@c2i.net
Liv	Borgen	
Kari	Dale 	
Åge	Dalen	dalen@c2i.net
Arve	Dalvik	a.dalvik@tiscali.no
Geir	Fjell 	gfjell@hotmail.com
Gjertrud	Fjell	
Kristoffer	Fjell	krisfjell@c2i.net
Mona	Gran	mona.gran@start.no
Mons	Larsen	monsla@online.no
Line	Li	lineli@start.no
Anita	Lia	anita124@online.no
Petter	Lia	petterlia@tiscali.no
Jonas	Moen	jmoen@start.no
Beate	Monsen	beate2000@hotmail.com
Anette	Nilsen	anetten@start.no
Janne	Nilsen	janne100@tiscali.no
Kåre	Paulsen	kpaul@c2i.net
Amund	Pettersen	AmundP@online.no
Petter	Svendsen	petter1024@online.no
Johnny	Vik	jovik@start.no
Birger	Øverdal	birger@hotmail.com
Kari	Åsen	kari@msn.com
Rut	Hauge	ruthauge@online.no
Birger	Knudsen	
Oddbjørn	Lunn	
Anne Hem	Vestlie	annehem@tiscali.no